#################################
#@.#........#......z.#.........z#
#...........#......z.#..........#
#.##........#........#....#######
#....#...z......z..z.#....#....P#
#..###...#########...#....#.....#
#..#......#..........#....###...#
#....########........#..........#
#.#.........######...#..........#
#....z.....z............z###...z#
#################################