#################################
#@.#.......+#......z.#.........z#
#...........#......z.#..........#
#.##........#........#....#######
#....#...z......z..z.#....#....P#
#..###...#########...#....#.....#
#..#......#..........#....###...#
#....########........#......d...#
#.#.........######...#..........#
#+...z.....z............z###...z#
#################################