#################################
#@.#........#........#..........#
#...........#........#..........#
####........#........#....#######
#....#...............#....#....P#
#..###...#########...#....#.....#
#..#......#..........#....###...#
#....########........#..........#
###.........######...#..........#
#........................###....#
#################################